State,Year,Undergrad,Professional,Grad,Total
Alabama ,2018,16,2,21,39
Alaska ,2018,4,0,9,13
Arizona ,2018,32,8,70,110
Arkansas ,2018,5,2,12,19
California ,2018,1060,45,634,1739
Colorado ,2018,38,4,81,123
Connecticut ,2018,43,5,57,105
Delaware ,2018,7,1,7,15
District of Columbia ,2018,6,0,14,20
Florida ,2018,89,19,153,261
Georgia ,2018,87,8,88,183
Guam ,2018,1,0,0,1
Hawaii ,2018,10,0,11,21
Idaho ,2018,4,0,10,14
Illinois ,2018,24659,514,3572,28745
Indiana ,2018,58,18,116,192
Iowa ,2018,35,6,49,90
Kansas ,2018,27,1,33,61
Kentucky ,2018,24,2,24,50
Louisiana ,2018,7,2,18,27
Maine ,2018,0,0,11,11
Maryland ,2018,67,5,87,159
Massachusetts ,2018,101,14,84,199
Michigan ,2018,84,40,163,287
Minnesota ,2018,62,7,96,165
Mississippi ,2018,6,1,10,17
Missouri ,2018,102,9,108,219
Montana ,2018,1,0,5,6
Nebraska ,2018,7,2,27,36
Nevada ,2018,12,2,13,27
New Hampshire ,2018,18,0,10,28
New Jersey ,2018,304,14,141,459
New Mexico ,2018,5,0,22,27
New York ,2018,141,27,179,347
North Carolina ,2018,39,8,72,119
North Dakota ,2018,0,0,5,5
Ohio ,2018,74,28,114,216
Oklahoma ,2018,14,0,27,41
Oregon ,2018,17,0,47,64
Pennsylvania ,2018,64,16,104,184
Alabama,2017,20,2,14,36
Alaska,2017,5,0,6,11
Arizona,2017,39,7,59,105
Arkansas,2017,6,2,14,22
California,2017,1011,43,425,1479
Colorado,2017,47,5,67,119
Connecticut,2017,40,6,39,85
Delaware,2017,5,0,3,8
District of Columbia,2017,2,1,9,12
Florida,2017,89,20,101,210
Georgia,2017,89,4,56,149
Guam,2017,1,0,0,1
Hawaii,2017,9,0,10,19
Idaho,2017,5,1,14,20
Illinois,2017,24251,537,3330,28118
Indiana,2017,65,17,103,185
Iowa,2017,39,3,43,85
Kansas,2017,24,2,26,52
Kentucky,2017,30,3,24,57
Louisiana,2017,9,2,20,31
Maine,2017,3,0,12,15
Maryland,2017,62,5,69,136
Massachusetts,2017,98,14,72,184
Michigan,2017,86,41,131,258
Military,2017,6,1,3,10
Minnesota,2017,77,7,77,161
Mississippi,2017,6,0,10,16
Missouri,2017,122,10,127,259
Montana,2017,1,0,3,4
Nebraska,2017,7,1,28,36
Nevada,2017,11,3,7,21
New Hampshire,2017,16,1,10,27
New Jersey,2017,328,14,88,430
New Mexico,2017,8,0,24,32
New York,2017,176,19,154,349
North Carolina,2017,31,3,57,91
North Dakota,2017,0,1,4,5
Ohio,2017,101,22,103,226
Oklahoma,2017,17,0,13,30
Oregon,2017,17,0,41,58
Pennsylvania,2017,68,14,83,165
Puerto Rico,2017,3,3,20,26
Rhode Island,2017,6,0,6,12
South Carolina,2017,7,2,17,26
South Dakota,2017,3,1,4,8
Tennessee,2017,45,4,53,102
Texas,2017,162,18,188,368
Unknown,2017,282,59,1435,1776
Utah,2017,7,0,21,28
Vermont,2017,1,0,6,7
Virgin Islands,2017,0,0,1,1
Virginia,2017,133,7,77,217
Washington,2017,60,2,82,144
West Virginia,2017,1,3,12,16
Wisconsin,2017,66,17,87,170
Wyoming,2017,3,0,5,8
Alabama,2016,17,2,15,34
Alaska,2016,3,0,4,7
Arizona,2016,34,5,31,70
Arkansas,2016,10,1,13,24
California,2016,937,42,226,1205
Colorado,2016,52,3,33,88
Connecticut,2016,43,4,21,68
Delaware,2016,6,0,3,9
District of Columbia,2016,4,2,3,9
Florida,2016,99,26,56,181
Georgia,2016,81,3,33,117
Guam,2016,1,0,0,1
Hawaii,2016,8,0,9,17
Idaho,2016,3,1,12,16
Illinois,2016,24169,542,2458,27169
Indiana,2016,58,16,80,154
Iowa,2016,35,3,39,77
Kansas,2016,25,2,15,42
Kentucky,2016,30,3,23,56
Louisiana,2016,10,2,16,28
Maine,2016,5,0,9,14
Maryland,2016,66,7,46,119
Massachusetts,2016,105,10,45,160
Michigan,2016,81,46,101,228
Military,2016,8,0,1,9
Minnesota,2016,80,9,52,141
Mississippi,2016,5,0,6,11
Missouri,2016,134,6,75,215
Montana,2016,0,0,4,4
Nebraska,2016,7,3,18,28
Nevada,2016,8,3,5,16
New Hampshire,2016,17,1,7,25
New Jersey,2016,312,17,49,378
New Mexico,2016,8,1,18,27
New York,2016,176,19,98,293
North Carolina,2016,28,1,44,73
North Dakota,2016,1,0,1,2
Ohio,2016,129,13,79,221
Oklahoma,2016,18,0,7,25
Oregon,2016,16,1,21,38
Pennsylvania,2016,75,10,54,139
Puerto Rico,2016,6,1,19,26
Rhode Island,2016,2,0,5,7
South Carolina,2016,5,2,15,22
South Dakota,2016,2,0,4,6
Tennessee,2016,46,2,36,84
Texas,2016,164,16,92,272
Unknown,2016,525,65,1146,1736
Utah,2016,7,0,14,21
Vermont,2016,2,0,3,5
Virginia,2016,133,8,41,182
Washington,2016,67,4,38,109
West Virginia,2016,0,3,8,11
Wisconsin,2016,60,14,65,139
Wyoming,2016,1,0,3,4
Alabama,2015,15,1,15,31
Alaska,2015,2,0,5,7
Arizona,2015,37,3,26,66
Arkansas,2015,9,1,12,22
California,2015,828,38,232,1098
Colorado,2015,52,0,33,85
Connecticut,2015,40,3,22,65
Delaware,2015,4,0,4,8
District of Columbia,2015,5,1,4,10
Florida,2015,111,17,47,175
Georgia,2015,59,3,31,93
Guam,2015,1,0,1,2
Hawaii,2015,7,0,8,15
Idaho,2015,2,1,8,11
Illinois,2015,23720,607,2580,26907
Indiana,2015,62,12,76,150
Iowa,2015,28,1,40,69
Kansas,2015,19,2,22,43
Kentucky,2015,32,3,23,58
Louisiana,2015,12,1,12,25
Maine,2015,4,2,8,14
Maryland,2015,73,5,45,123
Massachusetts,2015,106,9,33,148
Michigan,2015,76,39,110,225
Military,2015,7,0,3,10
Minnesota,2015,71,4,51,126
Mississippi,2015,4,0,6,10
Missouri,2015,138,9,67,214
Montana,2015,0,0,3,3
Nebraska,2015,5,2,19,26
Nevada,2015,8,2,6,16
New Hampshire,2015,13,1,11,25
New Jersey,2015,317,13,42,372
New Mexico,2015,7,1,11,19
New York,2015,182,12,98,292
North Carolina,2015,26,1,38,65
North Dakota,2015,0,1,1,2
Ohio,2015,144,13,84,241
Oklahoma,2015,17,0,5,22
Oregon,2015,19,3,17,39
Pennsylvania,2015,78,9,62,149
Puerto Rico,2015,5,1,20,26
Rhode Island,2015,2,0,5,7
South Carolina,2015,5,4,16,25
South Dakota,2015,3,0,8,11
Tennessee,2015,43,4,27,74
Texas,2015,148,13,81,242
Unknown,2015,548,48,1177,1773
Utah,2015,8,0,15,23
Vermont,2015,3,0,4,7
Virginia,2015,128,4,42,174
Washington,2015,61,5,34,100
West Virginia,2015,4,0,5,9
Wisconsin,2015,61,14,64,139
Wyoming,2015,1,0,2,3
Alabama,2014,10,0,17,27
Alaska,2014,3,0,7,10
Arizona,2014,28,3,21,52
Arkansas,2014,10,1,8,19
California,2014,643,37,204,884
Colorado,2014,51,2,27,80
Connecticut,2014,34,3,19,56
Delaware,2014,7,0,5,12
District of Columbia,2014,5,1,4,10
Florida,2014,97,11,47,155
Georgia,2014,54,4,31,89
Guam,2014,1,0,1,2
Hawaii,2014,7,0,7,14
Idaho,2014,5,1,8,14
Illinois,2014,23853,630,2677,27160
Indiana,2014,58,9,73,140
Iowa,2014,29,2,49,80
Kansas,2014,22,1,30,53
Kentucky,2014,33,3,25,61
Louisiana,2014,13,1,15,29
Maine,2014,3,1,6,10
Maryland,2014,78,7,43,128
Massachusetts,2014,102,10,36,148
Michigan,2014,85,34,114,233
Military,2014,6,0,1,7
Minnesota,2014,69,5,50,124
Mississippi,2014,3,0,8,11
Missouri,2014,141,10,73,224
Montana,2014,0,0,3,3
Nebraska,2014,11,1,16,28
Nevada,2014,9,1,5,15
New Hampshire,2014,11,1,12,24
New Jersey,2014,280,14,44,338
New Mexico,2014,6,1,10,17
New York,2014,166,16,99,281
North Carolina,2014,26,1,36,63
North Dakota,2014,0,1,4,5
Ohio,2014,135,7,76,218
Oklahoma,2014,12,1,8,21
Oregon,2014,19,5,12,36
Pennsylvania,2014,73,9,70,152
Puerto Rico,2014,6,1,17,24
Rhode Island,2014,3,0,7,10
South Carolina,2014,8,1,16,25
South Dakota,2014,6,0,7,13
Tennessee,2014,42,4,25,71
Texas,2014,119,17,85,221
Unknown,2014,596,52,1214,1862
Utah,2014,6,0,16,22
Vermont,2014,1,0,4,5
Virginia,2014,123,3,39,165
Washington,2014,63,5,35,103
West Virginia,2014,4,0,6,10
Wisconsin,2014,65,15,71,151
Wyoming,2014,1,0,1,2
Alabama,2013,7,1,11,19
Alaska,2013,3,0,3,6
Arizona,2013,18,3,22,43
Arkansas,2013,12,2,10,24
California,2013,490,33,169,692
Colorado,2013,47,6,16,69
Connecticut,2013,39,4,20,63
Delaware,2013,6,0,5,11
District of Columbia,2013,2,1,4,7
Florida,2013,80,16,56,152
Georgia,2013,44,5,23,72
Guam,2013,0,0,1,1
Hawaii,2013,9,1,10,20
Idaho,2013,1,1,6,8
Illinois,2013,24299,677,2825,27801
Indiana,2013,57,11,68,136
Iowa,2013,27,3,51,81
Kansas,2013,23,1,29,53
Kentucky,2013,28,3,26,57
Louisiana,2013,14,1,14,29
Maine,2013,3,1,4,8
Maryland,2013,74,5,45,124
Massachusetts,2013,100,7,34,141
Michigan,2013,83,29,105,217
Military,2013,4,0,1,5
Minnesota,2013,53,6,49,108
Mississippi,2013,6,0,10,16
Missouri,2013,138,9,84,231
Montana,2013,0,0,3,3
Nebraska,2013,10,0,16,26
Nevada,2013,8,1,4,13
New Hampshire,2013,10,2,15,27
New Jersey,2013,243,8,48,299
New Mexico,2013,3,1,11,15
New York,2013,137,16,106,259
North Carolina,2013,24,1,32,57
North Dakota,2013,0,1,4,5
Ohio,2013,123,13,74,210
Oklahoma,2013,15,1,4,20
Oregon,2013,19,3,17,39
Pennsylvania,2013,62,8,74,144
Puerto Rico,2013,4,0,17,21
Rhode Island,2013,2,0,8,10
South Carolina,2013,8,2,14,24
South Dakota,2013,5,1,7,13
Tennessee,2013,39,3,27,69
Texas,2013,121,17,84,222
Unknown,2013,574,52,1253,1879
Utah,2013,3,0,19,22
Vermont,2013,1,0,3,4
Virginia,2013,112,4,43,159
Washington,2013,43,8,34,85
West Virginia,2013,5,0,6,11
Wisconsin,2013,60,16,68,144
Wyoming,2013,0,1,2,3
Alabama,2012,9,1,10,20
Alaska,2012,5,0,4,9
Arizona,2012,22,3,17,42
Arkansas,2012,10,2,12,24
California,2012,366,40,172,578
Colorado,2012,41,6,16,63
Connecticut,2012,31,4,17,52
Delaware,2012,6,0,7,13
District of Columbia,2012,3,0,5,8
Florida,2012,81,17,58,156
Georgia,2012,45,4,24,73
Hawaii,2012,6,1,10,17
Idaho,2012,2,2,7,11
Illinois,2012,24683,701,2839,28223
Indiana,2012,56,11,78,145
Iowa,2012,20,2,46,68
Kansas,2012,20,2,18,40
Kentucky,2012,25,4,20,49
Louisiana,2012,8,2,10,20
Maine,2012,5,3,2,10
Maryland,2012,67,6,41,114
Massachusetts,2012,94,8,42,144
Michigan,2012,63,36,89,188
Military,2012,7,0,0,7
Minnesota,2012,58,6,48,112
Mississippi,2012,5,1,8,14
Missouri,2012,140,12,92,244
Montana,2012,0,0,6,6
Nebraska,2012,11,1,14,26
Nevada,2012,9,1,6,16
New Hampshire,2012,8,1,13,22
New Jersey,2012,207,8,49,264
New Mexico,2012,7,0,12,19
New York,2012,125,22,101,248
North Carolina,2012,25,1,32,58
North Dakota,2012,0,0,3,3
Ohio,2012,127,17,66,210
Oklahoma,2012,12,1,9,22
Oregon,2012,16,4,12,32
Other US,2012,3,1,20,24
Pennsylvania,2012,59,14,70,143
Rhode Island,2012,2,0,9,11
South Carolina,2012,5,1,10,16
South Dakota,2012,5,1,6,12
Tennessee,2012,37,3,30,70
Texas,2012,109,19,89,217
Unknown,2012,606,72,1269,1947
Utah,2012,4,0,16,20
Vermont,2012,1,1,2,4
Virginia,2012,81,5,48,134
Washington,2012,31,8,40,79
West Virginia,2012,7,0,8,15
Wisconsin,2012,69,13,77,159
Wyoming,2012,1,1,0,2
Alabama,2011,15,2,10,27
Alaska,2011,6,0,4,10
Arizona,2011,15,2,17,34
Arkansas,2011,10,2,9,21
California,2011,262,43,161,466
Colorado,2011,28,10,15,53
Connecticut,2011,35,5,24,64
Delaware,2011,2,1,5,8
District of Columbia,2011,5,0,4,9
Florida,2011,69,19,66,154
Georgia,2011,46,5,27,78
Hawaii,2011,5,1,8,14
Idaho,2011,3,3,10,16
Illinois,2011,25197,687,2845,28729
Indiana,2011,55,11,66,132
Iowa,2011,32,1,48,81
Kansas,2011,25,3,15,43
Kentucky,2011,23,3,22,48
Louisiana,2011,5,2,8,15
Maine,2011,2,1,5,8
Maryland,2011,67,4,47,118
Massachusetts,2011,92,5,38,135
Michigan,2011,65,40,82,187
Military,2011,11,0,0,11
Minnesota,2011,56,6,53,115
Mississippi,2011,4,1,7,12
Missouri,2011,133,11,78,222
Montana,2011,0,0,6,6
Nebraska,2011,12,2,14,28
Nevada,2011,9,0,5,14
New Hampshire,2011,7,1,11,19
New Jersey,2011,195,11,45,251
New Mexico,2011,7,0,13,20
New York,2011,98,23,92,213
North Carolina,2011,27,3,28,58
North Dakota,2011,0,0,6,6
Ohio,2011,126,21,69,216
Oklahoma,2011,9,1,12,22
Oregon,2011,12,4,19,35
Other US,2011,8,1,19,28
Pennsylvania,2011,56,21,69,146
Rhode Island,2011,4,0,11,15
South Carolina,2011,3,2,13,18
South Dakota,2011,5,2,3,10
Tennessee,2011,35,2,28,65
Texas,2011,100,25,89,214
Unknown,2011,624,84,1325,2033
Utah,2011,4,1,10,15
Vermont,2011,2,0,2,4
Virginia,2011,61,5,40,106
Washington,2011,26,7,31,64
West Virginia,2011,4,1,7,12
Wisconsin,2011,67,13,75,155
Wyoming,2011,1,1,0,2
Alabama,2010,13,2,7,22
Alaska,2010,6,1,5,12
Arizona,2010,20,4,16,40
Arkansas,2010,8,2,6,16
California,2010,187,48,161,396
Colorado,2010,23,6,20,49
Connecticut,2010,32,3,21,56
Delaware,2010,1,1,6,8
District of Columbia,2010,10,0,6,16
Florida,2010,67,15,68,150
Georgia,2010,31,4,32,67
Hawaii,2010,6,1,9,16
Idaho,2010,2,2,10,14
Illinois,2010,25465,704,2901,29070
Indiana,2010,49,6,63,118
Iowa,2010,26,2,53,81
Kansas,2010,33,5,14,52
Kentucky,2010,15,4,24,43
Louisiana,2010,6,2,10,18
Maine,2010,2,1,7,10
Maryland,2010,62,2,41,105
Massachusetts,2010,80,3,35,118
Michigan,2010,50,38,84,172
Military,2010,7,0,0,7
Minnesota,2010,43,4,60,107
Mississippi,2010,2,1,8,11
Missouri,2010,133,12,82,227
Montana,2010,1,0,4,5
Nebraska,2010,8,2,22,32
Nevada,2010,8,0,6,14
New Hampshire,2010,9,0,8,17
New Jersey,2010,169,13,41,223
New Mexico,2010,4,0,14,18
New York,2010,90,23,79,192
North Carolina,2010,18,5,31,54
North Dakota,2010,1,0,5,6
Ohio,2010,121,19,74,214
Oklahoma,2010,12,1,9,22
Oregon,2010,12,2,19,33
Other US,2010,4,1,22,27
Pennsylvania,2010,48,19,65,132
Rhode Island,2010,4,1,9,14
South Carolina,2010,7,2,8,17
South Dakota,2010,1,1,2,4
Tennessee,2010,25,2,29,56
Texas,2010,87,25,76,188
Unknown,2010,612,79,1432,2123
Utah,2010,2,5,11,18
Vermont,2010,1,1,0,2
Virginia,2010,56,2,36,94
Washington,2010,22,4,33,59
West Virginia,2010,4,1,5,10
Wisconsin,2010,50,7,77,134
Wyoming,2010,2,0,0,2
Alabama,2009,13,2,7,22
Alaska,2009,6,1,5,12
Arizona,2009,20,4,16,40
Arkansas,2009,8,2,6,16
California,2009,187,48,161,396
Colorado,2009,23,6,20,49
Connecticut,2009,32,3,21,56
Delaware,2009,1,1,6,8
District of Columbia,2009,10,0,6,16
Florida,2009,67,15,68,150
Georgia,2009,31,4,32,67
Hawaii,2009,6,1,9,16
Idaho,2009,2,2,10,14
Illinois,2009,25465,704,2901,29070
Indiana,2009,49,6,63,118
Iowa,2009,26,2,53,81
Kansas,2009,33,5,14,52
Kentucky,2009,15,4,24,43
Louisiana,2009,6,2,10,18
Maine,2009,2,1,7,10
Maryland,2009,62,2,41,105
Massachusetts,2009,80,3,35,118
Michigan,2009,50,38,84,172
Military,2009,7,0,0,7
Minnesota,2009,43,4,60,107
Mississippi,2009,2,1,8,11
Missouri,2009,133,12,82,227
Montana,2009,1,0,4,5
Nebraska,2009,8,2,22,32
Nevada,2009,8,0,6,14
New Hampshire,2009,9,0,8,17
New Jersey,2009,169,13,41,223
New Mexico,2009,4,0,14,18
New York,2009,90,23,79,192
North Carolina,2009,18,5,31,54
North Dakota,2009,1,0,5,6
Ohio,2009,121,19,74,214
Oklahoma,2009,12,1,9,22
Oregon,2009,12,2,19,33
Other US,2009,4,1,22,27
Pennsylvania,2009,48,19,65,132
Rhode Island,2009,4,1,9,14
South Carolina,2009,7,2,8,17
South Dakota,2009,1,1,2,4
Tennessee,2009,25,2,29,56
Texas,2009,87,25,76,188
Unknown,2009,612,79,1432,2123
Utah,2009,2,5,11,18
Vermont,2009,1,1,0,2
Virginia,2009,56,2,36,94
Washington,2009,22,4,33,59
West Virginia,2009,4,1,5,10
Wisconsin,2009,50,7,77,134
Wyoming,2009,2,0,0,2
Alabama,2008,12,2,8,22
Alaska,2008,3,2,4,9
Arizona,2008,19,6,7,32
Arkansas,2008,3,2,10,15
California,2008,145,25,136,306
Colorado,2008,20,4,15,39
Connecticut,2008,28,4,17,49
Delaware,2008,5,0,5,10
District of Columbia,2008,12,0,6,18
Florida,2008,50,8,60,118
Georgia,2008,28,3,27,58
Hawaii,2008,6,1,6,13
Idaho,2008,2,1,10,13
Illinois,2008,26677,707,2903,30287
Indiana,2008,65,3,68,136
Iowa,2008,29,5,45,79
Kansas,2008,38,1,15,54
Kentucky,2008,25,2,27,54
Louisiana,2008,4,1,14,19
Maine,2008,3,1,6,10
Maryland,2008,74,3,43,120
Massachusetts,2008,65,3,20,88
Michigan,2008,60,17,75,152
Military,2008,6,0,0,6
Minnesota,2008,37,3,43,83
Mississippi,2008,5,0,5,10
Missouri,2008,167,8,72,247
Montana,2008,1,0,3,4
Nebraska,2008,14,2,15,31
Nevada,2008,11,0,3,14
New Hampshire,2008,9,1,5,15
New Jersey,2008,157,12,31,200
New Mexico,2008,3,0,16,19
New York,2008,76,16,73,165
North Carolina,2008,25,4,36,65
North Dakota,2008,1,1,3,5
Ohio,2008,113,12,75,200
Oklahoma,2008,10,0,9,19
Oregon,2008,7,1,15,23
Other US,2008,13,0,17,30
Pennsylvania,2008,45,6,49,100
Rhode Island,2008,3,1,6,10
South Carolina,2008,12,1,15,28
South Dakota,2008,1,0,4,5
Tennessee,2008,28,1,36,65
Texas,2008,102,14,66,182
Unknown,2008,568,103,1546,2217
Utah,2008,4,5,19,28
Vermont,2008,6,2,1,9
Virginia,2008,67,4,36,107
Washington,2008,23,6,30,59
West Virginia,2008,5,0,5,10
Wisconsin,2008,48,4,51,103
Wyoming,2008,1,0,0,1
Alabama,2007,11,3,9,23
Alaska,2007,2,0,4,6
Arizona,2007,17,4,8,29
Arkansas,2007,8,2,12,22
California,2007,152,22,121,295
Colorado,2007,20,1,14,35
Connecticut,2007,21,3,13,37
Delaware,2007,7,0,5,12
District of Columbia,2007,8,0,6,14
Florida,2007,43,11,50,104
Georgia,2007,25,5,25,55
Hawaii,2007,6,1,5,12
Idaho,2007,2,1,8,11
Illinois,2007,26848,686,2894,30428
Indiana,2007,74,4,75,153
Iowa,2007,34,4,42,80
Kansas,2007,34,0,25,59
Kentucky,2007,28,2,22,52
Louisiana,2007,7,2,15,24
Maine,2007,2,0,6,8
Maryland,2007,76,4,41,121
Massachusetts,2007,59,3,22,84
Michigan,2007,63,17,55,135
Military,2007,3,0,0,3
Minnesota,2007,39,0,43,82
Mississippi,2007,6,0,3,9
Missouri,2007,174,9,67,250
Montana,2007,1,0,3,4
Nebraska,2007,15,2,18,35
Nevada,2007,11,0,4,15
New Hampshire,2007,12,1,3,16
New Jersey,2007,130,15,29,174
New Mexico,2007,6,1,13,20
New York,2007,72,15,75,162
North Carolina,2007,16,3,27,46
North Dakota,2007,3,1,3,7
Ohio,2007,104,12,65,181
Oklahoma,2007,17,0,6,23
Oregon,2007,5,1,16,22
Other US,2007,11,0,17,28
Pennsylvania,2007,32,8,38,78
Rhode Island,2007,4,0,1,5
South Carolina,2007,9,1,17,27
South Dakota,2007,1,0,6,7
Tennessee,2007,25,3,22,50
Texas,2007,92,10,70,172
Unknown,2007,486,113,1581,2180
Utah,2007,4,1,21,26
Vermont,2007,7,1,0,8
Virginia,2007,68,4,29,101
Washington,2007,29,4,33,66
West Virginia,2007,5,0,5,10
Wisconsin,2007,56,4,47,107
Wyoming,2007,1,0,0,1
Alabama,2006,11,1,9,21
Alaska,2006,3,1,4,8
Arizona,2006,25,6,9,40
Arkansas,2006,9,0,11,20
California,2006,158,21,122,301
Colorado,2006,27,1,15,43
Connecticut,2006,22,4,13,39
Delaware,2006,5,0,4,9
District of Columbia,2006,7,1,1,9
Florida,2006,42,8,44,94
Georgia,2006,31,6,24,61
Hawaii,2006,8,0,5,13
Idaho,2006,3,2,6,11
Illinois,2006,27049,703,2828,30580
Indiana,2006,79,3,57,139
Iowa,2006,41,4,37,82
Kansas,2006,35,2,29,66
Kentucky,2006,38,1,26,65
Louisiana,2006,12,2,11,25
Maine,2006,2,0,4,6
Maryland,2006,80,5,40,125
Massachusetts,2006,51,5,15,71
Michigan,2006,79,17,67,163
Military,2006,1,0,0,1
Minnesota,2006,44,2,38,84
Mississippi,2006,4,1,4,9
Missouri,2006,202,8,66,276
Montana,2006,0,0,2,2
Nebraska,2006,20,2,17,39
Nevada,2006,10,0,2,12
New Hampshire,2006,15,2,4,21
New Jersey,2006,138,15,32,185
New Mexico,2006,5,2,10,17
New York,2006,84,18,81,183
North Carolina,2006,20,4,24,48
North Dakota,2006,3,0,1,4
Ohio,2006,115,8,69,192
Oklahoma,2006,23,1,10,34
Oregon,2006,15,1,14,30
Other US,2006,13,0,19,32
Pennsylvania,2006,39,7,35,81
Rhode Island,2006,2,0,1,3
South Carolina,2006,7,0,13,20
South Dakota,2006,3,0,3,6
Tennessee,2006,28,3,21,52
Texas,2006,85,13,71,169
Unknown,2006,498,132,1659,2289
Utah,2006,4,2,20,26
Vermont,2006,8,2,1,11
Virginia,2006,69,1,24,94
Washington,2006,32,1,25,58
West Virginia,2006,5,0,3,8
Wisconsin,2006,61,3,49,113
Wyoming,2006,1,0,0,1
Alabama,2005,16,0,5,21
Alaska,2005,5,1,3,9
Arizona,2005,26,4,13,43
Arkansas,2005,13,0,10,23
California,2005,159,27,112,298
Colorado,2005,30,2,17,49
Connecticut,2005,24,3,12,39
Delaware,2005,4,0,2,6
District of Columbia,2005,2,0,1,3
Florida,2005,55,5,31,91
Georgia,2005,21,5,27,53
Hawaii,2005,13,0,4,17
Idaho,2005,5,0,5,10
Illinois,2005,26539,718,2807,30064
Indiana,2005,89,1,48,138
Iowa,2005,40,3,29,72
Kansas,2005,37,2,24,63
Kentucky,2005,40,4,21,65
Louisiana,2005,10,0,9,19
Maine,2005,3,0,5,8
Maryland,2005,85,7,36,128
Massachusetts,2005,56,3,20,79
Michigan,2005,68,14,65,147
Military,2005,2,0,0,2
Minnesota,2005,48,1,25,74
Mississippi,2005,5,1,5,11
Missouri,2005,227,6,45,278
Montana,2005,1,0,2,3
Nebraska,2005,18,1,14,33
Nevada,2005,7,0,1,8
New Hampshire,2005,12,2,3,17
New Jersey,2005,154,14,28,196
New Mexico,2005,7,2,9,18
New York,2005,100,12,56,168
North Carolina,2005,26,1,26,53
North Dakota,2005,2,0,3,5
Ohio,2005,131,3,72,206
Oklahoma,2005,22,1,10,33
Oregon,2005,15,0,11,26
Other US,2005,10,0,19,29
Pennsylvania,2005,55,5,42,102
Rhode Island,2005,2,0,2,4
South Carolina,2005,10,0,14,24
South Dakota,2005,4,0,2,6
Tennessee,2005,38,3,17,58
Texas,2005,87,12,48,147
Unknown,2005,508,141,1804,2453
Utah,2005,7,2,17,26
Vermont,2005,6,0,1,7
Virginia,2005,74,0,33,107
Washington,2005,25,1,19,45
West Virginia,2005,5,1,5,11
Wisconsin,2005,54,3,41,98
Wyoming,2005,2,0,1,3
Alabama,2004,16,0,8,24
Alaska,2004,4,1,1,6
Arizona,2004,22,2,16,40
Arkansas,2004,17,0,6,23
California,2004,179,32,83,294
Colorado,2004,30,3,12,45
Connecticut,2004,18,4,9,31
Delaware,2004,4,0,2,6
District of Columbia,2004,2,1,5,8
Florida,2004,56,3,23,82
Georgia,2004,26,1,21,48
Hawaii,2004,13,0,3,16
Idaho,2004,3,1,3,7
Illinois,2004,25494,805,2941,29240
Indiana,2004,95,5,47,147
Iowa,2004,33,2,34,69
Kansas,2004,41,2,15,58
Kentucky,2004,30,3,16,49
Louisiana,2004,12,0,9,21
Maine,2004,5,1,2,8
Maryland,2004,89,9,30,128
Massachusetts,2004,53,9,25,87
Michigan,2004,68,20,54,142
Military,2004,6,0,0,6
Minnesota,2004,60,2,25,87
Mississippi,2004,4,0,4,8
Missouri,2004,244,5,41,290
Montana,2004,3,0,5,8
Nebraska,2004,18,1,11,30
Nevada,2004,6,1,1,8
New Hampshire,2004,7,2,2,11
New Jersey,2004,158,12,28,198
New Mexico,2004,9,1,9,19
New York,2004,102,10,56,168
North Carolina,2004,25,1,33,59
North Dakota,2004,3,0,2,5
Ohio,2004,139,4,56,199
Oklahoma,2004,28,2,6,36
Oregon,2004,17,1,10,28
Other US,2004,8,1,17,26
Pennsylvania,2004,54,5,44,103
Rhode Island,2004,3,0,1,4
South Carolina,2004,10,0,3,13
South Dakota,2004,5,0,0,5
Tennessee,2004,41,2,9,52
Texas,2004,93,7,41,141
Unknown,2004,473,82,1851,2406
Utah,2004,11,3,13,27
Vermont,2004,3,0,2,5
Virginia,2004,58,2,33,93
Washington,2004,32,1,10,43
West Virginia,2004,6,0,3,9
Wisconsin,2004,54,4,34,92
Wyoming,2004,3,0,2,5
Alabama,2003,23,0,26,49
Alaska,2003,5,1,8,14
Arizona,2003,24,1,35,60
Arkansas,2003,14,0,20,34
California,2003,176,35,251,462
Colorado,2003,35,8,36,79
Connecticut,2003,34,7,34,75
Delaware,2003,2,0,3,5
District of Columbia,2003,3,0,7,10
Florida,2003,55,8,73,136
Georgia,2003,26,3,41,70
Hawaii,2003,23,1,7,31
Idaho,2003,4,0,8,12
Illinois,2003,25129,825,3084,29038
Indiana,2003,86,8,123,217
Iowa,2003,34,2,76,112
Kansas,2003,46,2,45,93
Kentucky,2003,36,4,36,76
Louisiana,2003,8,2,26,36
Maine,2003,8,2,7,17
Maryland,2003,100,8,60,168
Massachusetts,2003,51,10,69,130
Michigan,2003,71,27,134,232
Military,2003,1,0,2,3
Minnesota,2003,58,0,89,147
Mississippi,2003,1,0,13,14
Missouri,2003,289,4,123,416
Montana,2003,2,1,7,10
Nebraska,2003,21,0,26,47
Nevada,2003,11,2,4,17
New Hampshire,2003,8,3,12,23
New Jersey,2003,155,10,76,241
New Mexico,2003,10,0,24,34
New York,2003,121,15,153,289
North Carolina,2003,22,12,60,94
North Dakota,2003,5,0,6,11
Ohio,2003,161,7,136,304
Oklahoma,2003,20,0,29,49
Oregon,2003,19,2,27,48
Other US,2003,7,2,31,40
Pennsylvania,2003,62,8,109,179
Rhode Island,2003,4,1,6,11
South Carolina,2003,10,1,12,23
South Dakota,2003,5,0,3,8
Tennessee,2003,43,1,42,86
Texas,2003,85,5,136,226
Utah,2003,6,4,52,62
Vermont,2003,2,0,7,9
Virginia,2003,74,9,78,161
Washington,2003,29,2,54,85
West Virginia,2003,5,0,9,14
Wisconsin,2003,59,7,97,163
Wyoming,2003,1,1,6,8
Alabama,2002,22,0,23,45
Alaska,2002,5,0,5,10
Arizona,2002,22,3,27,52
Arkansas,2002,11,1,16,28
California,2002,155,34,221,410
Colorado,2002,39,7,42,88
Connecticut,2002,32,7,26,65
Delaware,2002,4,1,5,10
District of Columbia,2002,2,1,8,11
Florida,2002,51,10,72,133
Georgia,2002,32,2,43,77
Hawaii,2002,34,0,6,40
Idaho,2002,2,0,8,10
Illinois,2002,25085,824,3091,29000
Indiana,2002,91,8,125,224
Iowa,2002,31,2,70,103
Kansas,2002,34,3,40,77
Kentucky,2002,34,2,35,71
Louisiana,2002,8,2,19,29
Maine,2002,6,1,9,16
Maryland,2002,81,6,54,141
Massachusetts,2002,43,10,65,118
Michigan,2002,68,21,119,208
Military,2002,1,0,1,2
Minnesota,2002,64,0,77,141
Mississippi,2002,3,0,14,17
Missouri,2002,286,6,109,401
Montana,2002,4,1,8,13
Nebraska,2002,28,1,26,55
Nevada,2002,11,2,3,16
New Hampshire,2002,7,2,12,21
New Jersey,2002,125,8,71,204
New Mexico,2002,10,0,24,34
New York,2002,122,20,153,295
North Carolina,2002,22,7,43,72
North Dakota,2002,3,0,6,9
Ohio,2002,161,11,124,296
Oklahoma,2002,19,0,30,49
Oregon,2002,14,1,26,41
Other US,2002,15,2,28,45
Pennsylvania,2002,61,6,95,162
Rhode Island,2002,5,3,4,12
South Carolina,2002,9,1,10,20
South Dakota,2002,4,0,4,8
Tennessee,2002,44,1,47,92
Texas,2002,72,4,126,202
Utah,2002,7,2,44,53
Vermont,2002,1,0,5,6
Virginia,2002,77,8,74,159
Washington,2002,22,1,54,77
West Virginia,2002,6,1,9,16
Wisconsin,2002,66,9,93,168
Wyoming,2002,0,1,4,5
Alabama,2001,21,0,20,41
Alaska,2001,5,0,11,16
Arizona,2001,21,3,26,50
Arkansas,2001,8,1,16,25
California,2001,146,28,223,397
Colorado,2001,30,7,42,79
Connecticut,2001,29,6,21,56
Delaware,2001,4,1,6,11
District of Columbia,2001,2,2,9,13
Florida,2001,58,10,67,135
Georgia,2001,18,5,38,61
Hawaii,2001,40,0,7,47
Idaho,2001,2,0,8,10
Illinois,2001,25106,835,2904,28845
Indiana,2001,87,7,122,216
Iowa,2001,35,3,59,97
Kansas,2001,41,4,37,82
Kentucky,2001,37,1,35,73
Louisiana,2001,10,2,20,32
Maine,2001,4,1,12,17
Maryland,2001,79,7,53,139
Massachusetts,2001,48,8,60,116
Michigan,2001,67,18,106,191
Military,2001,0,0,0,0
Minnesota,2001,72,0,75,147
Mississippi,2001,2,0,12,14
Missouri,2001,298,3,113,414
Montana,2001,1,1,9,11
Nebraska,2001,29,1,28,58
Nevada,2001,10,1,4,15
New Hampshire,2001,5,2,11,18
New Jersey,2001,125,8,75,208
New Mexico,2001,7,0,23,30
New York,2001,119,16,135,270
North Carolina,2001,19,5,43,67
North Dakota,2001,5,0,6,11
Ohio,2001,161,10,129,300
Oklahoma,2001,21,0,35,56
Oregon,2001,19,1,23,43
Other US,2001,17,3,27,47
Pennsylvania,2001,57,7,91,155
Rhode Island,2001,4,3,3,10
South Carolina,2001,9,2,10,21
South Dakota,2001,5,1,5,11
Tennessee,2001,41,1,39,81
Texas,2001,55,6,103,164
Utah,2001,8,3,43,54
Vermont,2001,1,0,6,7
Virginia,2001,86,8,73,167
Washington,2001,23,2,48,73
West Virginia,2001,5,1,9,15
Wisconsin,2001,63,13,83,159
Wyoming,2001,0,1,6,7
Alabama,2000,20,1,21,42
Alaska,2000,5,0,11,16
Arizona,2000,14,1,26,41
Arkansas,2000,11,3,19,33
California,2000,121,28,233,382
Colorado,2000,31,5,45,81
Connecticut,2000,35,6,24,65
Delaware,2000,5,1,5,11
District of Columbia,2000,3,2,13,18
Florida,2000,58,9,60,127
Georgia,2000,23,5,44,72
Hawaii,2000,54,0,8,62
Idaho,2000,2,0,8,10
Illinois,2000,25150,787,2787,28724
Indiana,2000,90,9,107,206
Iowa,2000,40,2,50,92
Kansas,2000,35,2,32,69
Kentucky,2000,42,0,33,75
Louisiana,2000,12,2,21,35
Maine,2000,6,0,7,13
Maryland,2000,69,5,46,120
Massachusetts,2000,48,5,48,101
Michigan,2000,56,15,98,169
Military,2000,1,0,0,1
Minnesota,2000,69,0,64,133
Mississippi,2000,4,0,12,16
Missouri,2000,284,5,103,392
Montana,2000,2,1,7,10
Nebraska,2000,37,1,20,58
Nevada,2000,12,0,8,20
New Hampshire,2000,5,2,12,19
New Jersey,2000,110,7,74,191
New Mexico,2000,7,0,25,32
New York,2000,115,23,136,274
North Carolina,2000,16,3,46,65
North Dakota,2000,4,1,7,12
Ohio,2000,174,11,139,324
Oklahoma,2000,17,0,35,52
Oregon,2000,16,1,28,45
Other US,2000,17,4,34,55
Pennsylvania,2000,57,6,98,161
Rhode Island,2000,7,2,9,18
South Carolina,2000,7,2,14,23
South Dakota,2000,5,2,4,11
Tennessee,2000,35,2,37,74
Texas,2000,47,6,98,151
Utah,2000,4,2,45,51
Vermont,2000,2,0,6,8
Virginia,2000,91,4,69,164
Washington,2000,13,3,39,55
West Virginia,2000,5,1,8,14
Wisconsin,2000,63,10,80,153
Wyoming,2000,1,0,5,6
Alabama,1999,19,2,21,42
Alaska,1999,5,0,14,19
Arizona,1999,12,4,23,39
Arkansas,1999,14,2,23,39
California,1999,102,28,215,345
Colorado,1999,33,3,46,82
Connecticut,1999,27,3,24,54
Delaware,1999,4,0,8,12
District of Columbia,1999,2,2,8,12
Florida,1999,50,8,62,120
Georgia,1999,21,6,41,68
Hawaii,1999,54,0,12,66
Idaho,1999,3,0,6,9
Illinois,1999,25222,766,2868,28856
Indiana,1999,98,9,103,210
Iowa,1999,47,3,53,103
Kansas,1999,27,2,24,53
Kentucky,1999,43,2,23,68
Louisiana,1999,7,0,15,22
Maine,1999,3,1,8,12
Maryland,1999,66,1,41,108
Massachusetts,1999,45,4,56,105
Michigan,1999,54,14,99,167
Minnesota,1999,73,2,63,138
Mississippi,1999,2,0,13,15
Missouri,1999,284,9,106,399
Montana,1999,3,1,5,9
Nebraska,1999,42,0,14,56
Nevada,1999,10,0,8,18
New Hampshire,1999,5,0,11,16
New Jersey,1999,108,10,60,178
New Mexico,1999,14,1,29,44
New York,1999,119,21,131,271
North Carolina,1999,14,2,47,63
North Dakota,1999,2,1,5,8
Ohio,1999,189,7,121,317
Oklahoma,1999,20,0,34,54
Oregon,1999,13,0,26,39
Other US,1999,17,2,21,40
Pennsylvania,1999,60,7,85,152
Rhode Island,1999,7,2,9,18
South Carolina,1999,12,3,12,27
South Dakota,1999,6,2,6,14
Tennessee,1999,43,2,37,82
Texas,1999,57,7,87,151
Utah,1999,6,3,41,50
Vermont,1999,4,0,8,12
Virginia,1999,89,2,60,151
Washington,1999,11,4,33,48
West Virginia,1999,7,0,7,14
Wisconsin,1999,70,5,91,166
Wyoming,1999,1,1,5,7
Alabama,1998,13,2,18,33
Alaska,1998,5,0,7,12
Arizona,1998,11,4,20,35
Arkansas,1998,14,2,18,34
California,1998,108,26,211,345
Colorado,1998,26,2,41,69
Connecticut,1998,30,3,25,58
Delaware,1998,4,0,7,11
District of Columbia,1998,2,1,7,10
Florida,1998,50,3,61,114
Georgia,1998,23,3,39,65
Hawaii,1998,58,0,6,64
Idaho,1998,3,0,6,9
Illinois,1998,24807,760,3096,28663
Indiana,1998,90,10,98,198
Iowa,1998,39,2,59,100
Kansas,1998,31,1,25,57
Kentucky,1998,34,3,22,59
Louisiana,1998,13,0,13,26
Maine,1998,3,2,9,14
Maryland,1998,77,3,44,124
Massachusetts,1998,48,6,47,101
Michigan,1998,62,12,102,176
Minnesota,1998,56,2,67,125
Mississippi,1998,4,0,18,22
Missouri,1998,288,14,107,409
Montana,1998,2,1,3,6
Nebraska,1998,39,1,16,56
Nevada,1998,10,0,3,13
New Hampshire,1998,4,0,10,14
New Jersey,1998,117,6,57,180
New Mexico,1998,12,1,28,41
New York,1998,120,17,143,280
North Carolina,1998,19,3,43,65
North Dakota,1998,1,0,6,7
Ohio,1998,205,10,127,342
Oklahoma,1998,17,0,34,51
Oregon,1998,13,0,29,42
Other US,1998,14,1,19,34
Pennsylvania,1998,53,4,74,131
Rhode Island,1998,6,1,8,15
South Carolina,1998,12,2,15,29
South Dakota,1998,5,2,6,13
Tennessee,1998,52,1,46,99
Texas,1998,53,5,100,158
Utah,1998,3,3,39,45
Vermont,1998,3,0,5,8
Virginia,1998,101,7,56,164
Washington,1998,8,4,36,48
West Virginia,1998,7,0,9,16
Wisconsin,1998,72,5,84,161
Wyoming,1998,0,1,5,6
Alabama,1997,14,1,22,37
Alaska,1997,6,0,8,14
Arizona,1997,10,4,18,32
Arkansas,1997,15,2,14,31
California,1997,113,27,206,346
Colorado,1997,33,1,37,71
Connecticut,1997,32,2,29,63
Delaware,1997,3,0,7,10
District of Columbia,1997,4,6,1,11
Florida,1997,48,3,59,110
Georgia,1997,26,1,37,64
Hawaii,1997,53,0,5,58
Idaho,1997,2,0,8,10
Illinois,1997,24292,762,3414,28468
Indiana,1997,79,10,92,181
Iowa,1997,44,2,61,107
Kansas,1997,31,1,19,51
Kentucky,1997,37,5,22,64
Louisiana,1997,17,0,17,34
Maine,1997,7,2,8,17
Maryland,1997,76,4,44,124
Massachusetts,1997,40,7,41,88
Michigan,1997,55,18,110,183
Minnesota,1997,46,2,59,107
Mississippi,1997,7,1,11,19
Missouri,1997,280,15,96,391
Montana,1997,3,0,9,12
Nebraska,1997,35,1,19,55
Nevada,1997,10,0,6,16
New Hampshire,1997,8,0,8,16
New Jersey,1997,106,8,58,172
New Mexico,1997,12,1,27,40
New York,1997,124,13,137,274
North Carolina,1997,19,3,45,67
North Dakota,1997,0,0,8,8
Ohio,1997,217,14,120,351
Oklahoma,1997,15,0,29,44
Oregon,1997,12,0,30,42
Pennsylvania,1997,58,6,78,142
Rhode Island,1997,6,1,7,14
South Carolina,1997,17,2,16,35
South Dakota,1997,5,1,7,13
Tennessee,1997,52,2,41,95
Texas,1997,44,7,100,151
Utah,1997,6,2,26,34
Vermont,1997,4,0,6,10
Virginia,1997,90,4,60,154
Washington,1997,7,5,40,52
West Virginia,1997,9,0,11,20
Wisconsin,1997,73,5,81,159
Wyoming,1997,0,1,4,5
Alabama,1996,14,0,24,38
Alaska,1996,5,0,10,15
Arizona,1996,14,3,18,35
Arkansas,1996,10,0,11,21
California,1996,116,28,168,312
Colorado,1996,31,2,30,63
Connecticut,1996,30,1,29,60
Delaware,1996,7,0,9,16
District of Columbia,1996,2,3,0,5
Florida,1996,52,3,60,115
Georgia,1996,31,0,26,57
Hawaii,1996,40,0,7,47
Idaho,1996,3,0,9,12
Illinois,1996,24231,773,3917,28921
Indiana,1996,78,10,96,184
Iowa,1996,36,1,55,92
Kansas,1996,27,0,15,42
Kentucky,1996,32,5,17,54
Louisiana,1996,12,0,20,32
Maine,1996,1,2,12,15
Maryland,1996,77,5,46,128
Massachusetts,1996,41,7,42,90
Michigan,1996,61,19,111,191
Minnesota,1996,4,0,54,58
Mississippi,1996,6,1,10,17
Missouri,1996,276,13,81,370
Montana,1996,2,0,5,7
Nebraska,1996,30,2,19,51
Nevada,1996,6,0,7,13
New Hampshire,1996,7,0,10,17
New Jersey,1996,123,9,53,185
New Mexico,1996,12,1,27,40
New York,1996,127,12,131,270
North Carolina,1996,22,2,39,63
North Dakota,1996,3,0,9,12
Ohio,1996,200,10,106,316
Oklahoma,1996,18,0,24,42
Oregon,1996,12,0,33,45
Pennsylvania,1996,67,4,75,146
Rhode Island,1996,6,2,5,13
South Carolina,1996,15,0,15,30
South Dakota,1996,2,0,6,8
Tennessee,1996,51,1,40,92
Texas,1996,45,5,92,142
Utah,1996,5,0,19,24
Vermont,1996,5,0,9,14
Virginia,1996,82,5,63,150
Washington,1996,14,3,32,49
West Virginia,1996,9,0,14,23
Wisconsin,1996,84,6,79,169
Wyoming,1996,1,0,1,2
Alabama,1995,12,0,20,32
Alaska,1995,6,0,15,21
Arizona,1995,17,1,24,42
Arkansas,1995,6,0,12,18
California,1995,102,14,133,249
Colorado,1995,33,0,25,58
Connecticut,1995,33,0,24,57
Delaware,1995,8,0,9,17
District of Columbia,1995,5,3,0,8
Florida,1995,48,2,50,100
Georgia,1995,29,2,30,61
Hawaii,1995,26,0,8,34
Idaho,1995,2,0,11,13
Illinois,1995,24408,845,4484,29737
Indiana,1995,68,5,79,152
Iowa,1995,35,0,45,80
Kansas,1995,29,0,17,46
Kentucky,1995,32,5,17,54
Louisiana,1995,11,0,19,30
Maine,1995,3,0,7,10
Maryland,1995,73,1,36,110
Massachusetts,1995,44,0,32,76
Michigan,1995,58,10,95,163
Minnesota,1995,33,1,55,89
Mississippi,1995,7,0,6,13
Missouri,1995,232,8,76,316
Montana,1995,4,0,3,7
Nebraska,1995,21,1,19,41
Nevada,1995,7,0,4,11
New Hampshire,1995,7,0,10,17
New Jersey,1995,109,2,49,160
New Mexico,1995,4,0,21,25
New York,1995,124,12,107,243
North Carolina,1995,29,0,36,65
North Dakota,1995,3,0,7,10
Ohio,1995,174,1,109,284
Oklahoma,1995,15,0,13,28
Oregon,1995,11,1,28,40
Pennsylvania,1995,66,0,77,143
Rhode Island,1995,3,1,3,7
South Carolina,1995,7,0,1,8
South Dakota,1995,1,0,6,7
Tennessee,1995,44,1,31,76
Texas,1995,44,2,63,109
Utah,1995,2,1,11,14
Vermont,1995,1,0,8,9
Virginia,1995,75,2,58,135
Washington,1995,14,0,25,39
West Virginia,1995,5,0,6,11
Wisconsin,1995,74,5,75,154
Wyoming,1995,2,0,2,4
Alabama,1994,8,0,12,20
Alaska,1994,3,0,7,10
Arizona,1994,17,1,14,32
Arkansas,1994,4,0,,4
California,1994,82,14,108,204
Colorado,1994,34,0,22,56
Connecticut,1994,27,0,16,43
Delaware,1994,7,0,4,11
District of Columbia,1994,4,2,0,6
Florida,1994,44,2,33,79
Georgia,1994,27,2,15,44
Hawaii,1994,16,0,6,22
Idaho,1994,0,0,7,7
Illinois,1994,24308,845,4927,30080
Indiana,1994,85,5,59,149
Iowa,1994,31,0,31,62
Kansas,1994,26,0,9,35
Kentucky,1994,34,5,13,52
Louisiana,1994,12,0,20,32
Maine,1994,1,0,7,8
Maryland,1994,57,1,37,95
Massachusetts,1994,36,0,25,61
Michigan,1994,57,10,76,143
Minnesota,1994,30,1,39,70
Mississippi,1994,8,0,7,15
Missouri,1994,227,8,69,304
Montana,1994,4,0,3,7
Nebraska,1994,12,1,12,25
Nevada,1994,6,0,3,9
New Hampshire,1994,6,0,7,13
New Jersey,1994,107,2,47,156
New Mexico,1994,3,0,24,27
New York,1994,107,12,83,202
North Carolina,1994,30,0,31,61
North Dakota,1994,2,0,6,8
Ohio,1994,140,1,83,224
Oklahoma,1994,14,0,9,23
Oregon,1994,6,1,16,23
Pennsylvania,1994,61,0,58,119
Rhode Island,1994,4,1,3,8
South Carolina,1994,9,0,11,20
South Dakota,1994,0,0,6,6
Tennessee,1994,37,1,19,57
Texas,1994,37,2,56,95
Utah,1994,1,1,2,4
Vermont,1994,1,0,6,7
Virginia,1994,48,2,41,91
Washington,1994,11,0,12,23
West Virginia,1994,3,0,3,6
Wisconsin,1994,66,5,56,127
Wyoming,1994,1,0,2,3
Alabama,1993,10,0,10,20
Alaska,1993,1,0,4,5
Arizona,1993,13,1,15,29
Arkansas,1993,5,1,7,13
California,1993,89,14,114,217
Colorado,1993,32,0,24,56
Connecticut,1993,32,1,20,53
Delaware,1993,9,1,2,12
District of Columbia,1993,2,4,0,6
Florida,1993,50,2,35,87
Georgia,1993,29,2,21,52
Hawaii,1993,11,0,6,17
Idaho,1993,1,0,5,6
Illinois,1993,24371,842,5086,30299
Indiana,1993,70,4,67,141
Iowa,1993,28,0,42,70
Kansas,1993,23,1,12,36
Kentucky,1993,44,2,25,71
Louisiana,1993,9,1,16,26
Maine,1993,0,0,4,4
Maryland,1993,47,1,39,87
Massachusetts,1993,46,0,26,72
Michigan,1993,56,13,74,143
Minnesota,1993,28,1,35,64
Mississippi,1993,5,0,10,15
Missouri,1993,191,5,80,276
Montana,1993,3,0,6,9
Nebraska,1993,10,0,13,23
Nevada,1993,6,0,1,7
New Hampshire,1993,7,0,8,15
New Jersey,1993,93,4,42,139
New Mexico,1993,6,0,13,19
New York,1993,108,14,96,218
North Carolina,1993,23,0,29,52
North Dakota,1993,2,0,4,6
Ohio,1993,140,1,87,228
Oklahoma,1993,13,0,12,25
Oregon,1993,9,0,9,18
Pennsylvania,1993,61,2,75,138
Rhode Island,1993,3,1,1,5
South Carolina,1993,9,0,11,20
South Dakota,1993,0,0,5,5
Tennessee,1993,33,2,25,60
Texas,1993,48,2,54,104
Utah,1993,1,1,2,4
Vermont,1993,0,0,4,4
Virginia,1993,42,1,41,84
Washington,1993,8,0,15,23
West Virginia,1993,3,0,5,8
Wisconsin,1993,58,3,55,116
Wyoming,1993,0,0,1,1
Alabama,1992,13,0,10,23
Alaska,1992,2,0,3,5
Arizona,1992,10,0,19,29
Arkansas,1992,5,2,9,16
California,1992,69,16,106,191
Colorado,1992,28,0,26,54
Connecticut,1992,29,1,20,50
Delaware,1992,3,2,5,10
District of Columbia,1992,1,2,0,3
Florida,1992,46,2,36,84
Georgia,1992,30,1,21,52
Hawaii,1992,11,0,7,18
Idaho,1992,1,0,4,5
Illinois,1992,23992,849,5056,29897
Indiana,1992,86,4,63,153
Iowa,1992,35,0,37,72
Kansas,1992,18,1,10,29
Kentucky,1992,44,1,26,71
Louisiana,1992,6,0,13,19
Maine,1992,3,0,2,5
Maryland,1992,44,0,34,78
Massachusetts,1992,43,0,26,69
Michigan,1992,42,14,85,141
Minnesota,1992,19,1,43,63
Mississippi,1992,4,0,7,11
Missouri,1992,169,2,88,259
Montana,1992,2,0,3,5
Nebraska,1992,14,0,13,27
Nevada,1992,7,1,0,8
New Hampshire,1992,9,0,5,14
New Jersey,1992,82,4,36,122
New Mexico,1992,7,0,10,17
New York,1992,96,11,114,221
North Carolina,1992,14,0,17,31
North Dakota,1992,1,0,4,5
Ohio,1992,137,3,87,227
Oklahoma,1992,15,0,15,30
Oregon,1992,8,0,9,17
Pennsylvania,1992,57,5,71,133
Rhode Island,1992,4,1,2,7
South Carolina,1992,12,0,7,19
South Dakota,1992,0,0,3,3
Tennessee,1992,38,1,19,58
Texas,1992,44,0,55,99
Utah,1992,2,1,6,9
Vermont,1992,2,0,2,4
Virginia,1992,44,4,31,79
Washington,1992,9,0,20,29
West Virginia,1992,6,0,7,13
Wisconsin,1992,66,2,54,122
Wyoming,1992,2,0,1,3
Alabama,1991,11,1,10,22
Alaska,1991,3,0,3,6
Arizona,1991,8,0,14,22
Arkansas,1991,4,3,6,13
California,1991,66,4,101,171
Colorado,1991,27,0,21,48
Connecticut,1991,29,3,19,51
Delaware,1991,5,1,7,13
District of Columbia,1991,1,3,0,4
Florida,1991,49,1,26,76
Georgia,1991,26,1,17,44
Hawaii,1991,8,0,8,16
Idaho,1991,1,0,6,7
Illinois,1991,24618,869,5068,30555
Indiana,1991,89,2,57,148
Iowa,1991,40,0,38,78
Kansas,1991,16,1,22,39
Kentucky,1991,41,1,25,67
Louisiana,1991,7,1,17,25
Maine,1991,4,0,1,5
Maryland,1991,34,1,36,71
Massachusetts,1991,38,0,26,64
Michigan,1991,44,9,81,134
Minnesota,1991,19,2,36,57
Mississippi,1991,2,0,9,11
Missouri,1991,181,5,69,255
Montana,1991,3,0,0,3
Nebraska,1991,14,0,14,28
Nevada,1991,2,0,4,6
New Hampshire,1991,9,0,4,13
New Jersey,1991,77,4,37,118
New Mexico,1991,6,0,12,18
New York,1991,89,5,91,185
North Carolina,1991,16,1,18,35
North Dakota,1991,1,0,6,7
Ohio,1991,110,2,57,169
Oklahoma,1991,10,0,13,23
Oregon,1991,6,0,12,18
Pennsylvania,1991,65,5,76,146
Rhode Island,1991,6,1,5,12
South Carolina,1991,5,0,12,17
South Dakota,1991,1,0,2,3
Tennessee,1991,43,2,25,70
Texas,1991,49,0,47,96
Utah,1991,1,1,4,6
Vermont,1991,3,0,3,6
Virginia,1991,36,1,34,71
Washington,1991,9,1,14,24
West Virginia,1991,6,0,3,9
Wisconsin,1991,53,1,53,107
Wyoming,1991,1,0,3,4
Alabama,1990,11,1,14,26
Alaska,1990,5,0,3,8
Arizona,1990,11,0,10,21
Arkansas,1990,8,0,6,14
California,1990,81,4,79,164
Colorado,1990,22,0,17,39
Connecticut,1990,33,2,14,49
Delaware,1990,6,0,3,9
District of Columbia,1990,3,1,0,4
Florida,1990,53,2,25,80
Georgia,1990,22,1,20,43
Hawaii,1990,7,0,12,19
Idaho,1990,0,0,4,4
Illinois,1990,24735,854,4765,30354
Indiana,1990,95,1,71,167
Iowa,1990,45,0,33,78
Kansas,1990,18,3,23,44
Kentucky,1990,42,1,22,65
Louisiana,1990,8,2,12,22
Maine,1990,4,0,0,4
Maryland,1990,30,3,28,61
Massachusetts,1990,26,1,24,51
Michigan,1990,38,6,100,144
Minnesota,1990,23,1,3,27
Mississippi,1990,0,0,7,7
Missouri,1990,177,6,60,243
Montana,1990,2,0,1,3
Nebraska,1990,18,0,1,19
Nevada,1990,2,0,3,5
New Hampshire,1990,9,0,6,15
New Jersey,1990,76,2,37,115
New Mexico,1990,5,0,14,19
New York,1990,88,3,96,187
North Carolina,1990,8,1,23,32
North Dakota,1990,2,0,5,7
Ohio,1990,116,2,76,194
Oklahoma,1990,8,0,12,20
Oregon,1990,8,0,12,20
Pennsylvania,1990,60,4,74,138
Rhode Island,1990,3,0,5,8
South Carolina,1990,8,0,14,22
South Dakota,1990,3,1,2,6
Tennessee,1990,39,2,28,69
Texas,1990,44,0,45,89
Utah,1990,1,0,5,6
Vermont,1990,2,0,2,4
Virginia,1990,42,0,25,67
Washington,1990,9,0,17,26
West Virginia,1990,8,0,3,11
Wisconsin,1990,45,1,50,96
Wyoming,1990,1,0,4,5
Alabama,1989,7,1,9,17
Alaska,1989,5,0,3,8
Arizona,1989,9,1,11,21
Arkansas,1989,5,1,6,12
California,1989,63,6,77,146
Colorado,1989,9,0,21,30
Connecticut,1989,31,2,13,46
Delaware,1989,6,0,3,9
District of Columbia,1989,0,3,0,3
Florida,1989,43,3,23,69
Georgia,1989,22,2,12,36
Hawaii,1989,5,0,7,12
Idaho,1989,0,0,2,2
Illinois,1989,24479,851,4784,30114
Indiana,1989,94,4,68,166
Iowa,1989,38,1,38,77
Kansas,1989,13,3,21,37
Kentucky,1989,36,0,23,59
Louisiana,1989,4,1,8,13
Maine,1989,3,0,1,4
Maryland,1989,20,2,23,45
Massachusetts,1989,30,1,23,54
Michigan,1989,37,1,74,112
Minnesota,1989,25,0,31,56
Mississippi,1989,0,0,6,6
Missouri,1989,159,6,62,227
Montana,1989,1,0,4,5
Nebraska,1989,16,1,8,25
Nevada,1989,2,0,2,4
New Hampshire,1989,5,0,4,9
New Jersey,1989,68,5,30,103
New Mexico,1989,5,0,10,15
New York,1989,69,6,89,164
North Carolina,1989,10,1,14,25
North Dakota,1989,0,0,4,4
Ohio,1989,91,0,63,154
Oklahoma,1989,9,1,9,19
Oregon,1989,3,1,11,15
Pennsylvania,1989,43,2,56,101
Rhode Island,1989,2,0,2,4
South Carolina,1989,7,2,10,19
South Dakota,1989,1,0,5,6
Tennessee,1989,36,1,27,64
Texas,1989,33,0,38,71
Utah,1989,1,0,9,10
Vermont,1989,3,1,1,5
Virginia,1989,24,0,27,51
Washington,1989,6,1,20,27
West Virginia,1989,8,0,2,10
Wisconsin,1989,44,0,40,84
Wyoming,1989,1,0,5,6
Alabama,1988,8,0,13,21
Alaska,1988,2,0,4,6
Arizona,1988,13,0,9,22
Arkansas,1988,6,0,4,10
California,1988,79,3,84,166
Colorado,1988,14,1,20,35
Connecticut,1988,28,1,6,35
Delaware,1988,6,0,3,9
District of Columbia,1988,1,4,0,5
Florida,1988,46,4,27,77
Georgia,1988,18,0,9,27
Hawaii,1988,5,1,5,11
Idaho,1988,0,0,1,1
Illinois,1988,25478,852,2995,29325
Indiana,1988,93,6,65,164
Iowa,1988,29,1,21,51
Kansas,1988,12,1,20,33
Kentucky,1988,34,0,15,49
Louisiana,1988,4,1,7,12
Maine,1988,2,0,2,4
Maryland,1988,21,1,14,36
Massachusetts,1988,18,1,27,46
Michigan,1988,32,4,72,108
Minnesota,1988,23,0,29,52
Mississippi,1988,2,0,6,8
Missouri,1988,167,7,56,230
Montana,1988,1,0,2,3
Nebraska,1988,14,1,13,28
Nevada,1988,2,0,5,7
New Hampshire,1988,4,0,2,6
New Jersey,1988,65,5,30,100
New Mexico,1988,6,0,14,20
New York,1988,69,7,86,162
North Carolina,1988,7,0,19,26
North Dakota,1988,0,0,3,3
Ohio,1988,89,2,69,160
Oklahoma,1988,10,0,13,23
Oregon,1988,3,0,11,14
Pennsylvania,1988,42,2,45,89
Rhode Island,1988,0,0,4,4
South Carolina,1988,5,1,6,12
South Dakota,1988,1,0,4,5
Tennessee,1988,26,0,35,61
Texas,1988,27,0,37,64
Utah,1988,0,0,3,3
Vermont,1988,2,1,1,4
Virginia,1988,24,0,30,54
Washington,1988,10,1,22,33
West Virginia,1988,3,0,1,4
Wisconsin,1988,35,2,32,69
Wyoming,1988,1,1,4,6
Alabama,1987,13,0,12,25
Alaska,1987,0,0,0,0
Arizona,1987,12,0,9,21
Arkansas,1987,5,1,10,16
California,1987,65,1,112,178
Colorado,1987,15,0,29,44
Connecticut,1987,25,3,9,37
Delaware,1987,3,0,0,3
District of Columbia,1987,1,5,0,6
Florida,1987,29,1,25,55
Georgia,1987,24,1,21,46
Hawaii,1987,0,0,0,0
Idaho,1987,1,0,5,6
Illinois,1987,25733,886,5029,31648
Indiana,1987,94,2,77,173
Iowa,1987,25,1,28,54
Kansas,1987,14,1,27,42
Kentucky,1987,39,0,21,60
Louisiana,1987,5,0,6,11
Maine,1987,1,0,1,2
Maryland,1987,26,0,23,49
Massachusetts,1987,18,0,30,48
Michigan,1987,40,5,71,116
Minnesota,1987,22,1,33,56
Mississippi,1987,2,0,4,6
Missouri,1987,174,5,71,250
Montana,1987,3,0,4,7
Nebraska,1987,16,0,10,26
Nevada,1987,2,0,3,5
New Hampshire,1987,4,0,4,8
New Jersey,1987,68,2,35,105
New Mexico,1987,6,0,11,17
New York,1987,59,3,82,144
North Carolina,1987,7,0,5,12
North Dakota,1987,1,0,6,7
Ohio,1987,92,3,77,172
Oklahoma,1987,7,0,12,19
Oregon,1987,4,0,8,12
Pennsylvania,1987,28,2,42,72
Rhode Island,1987,1,0,3,4
South Carolina,1987,3,1,10,14
South Dakota,1987,2,0,5,7
Tennessee,1987,24,0,30,54
Texas,1987,22,0,36,58
Utah,1987,0,0,8,8
Vermont,1987,1,1,4,6
Virginia,1987,21,0,32,53
Washington,1987,3,1,19,23
West Virginia,1987,4,0,4,8
Wisconsin,1987,40,0,51,91
Wyoming,1987,0,0,3,3
Alabama,1986,10,0,15,25
Alaska,1986,0,0,0,0
Arizona,1986,6,0,14,20
Arkansas,1986,5,1,6,12
California,1986,60,0,100,160
Colorado,1986,11,1,23,35
Connecticut,1986,19,3,18,40
Delaware,1986,2,0,7,9
District of Columbia,1986,0,8,0,8
Florida,1986,32,1,23,56
Georgia,1986,38,1,12,51
Hawaii,1986,1,0,1,2
Idaho,1986,0,0,3,3
Illinois,1986,26024,902,5034,31960
Indiana,1986,76,3,74,153
Iowa,1986,25,0,34,59
Kansas,1986,7,0,4,11
Kentucky,1986,36,0,26,62
Louisiana,1986,5,0,11,16
Maine,1986,2,0,4,6
Maryland,1986,25,1,23,49
Massachusetts,1986,12,1,37,50
Michigan,1986,35,9,70,114
Minnesota,1986,15,1,36,52
Mississippi,1986,2,0,3,5
Missouri,1986,165,10,64,239
Montana,1986,4,0,5,9
Nebraska,1986,7,1,18,26
Nevada,1986,1,0,1,2
New Hampshire,1986,5,0,6,11
New Jersey,1986,57,1,30,88
New Mexico,1986,4,0,13,17
New York,1986,52,4,84,140
North Carolina,1986,1,0,20,21
North Dakota,1986,1,0,10,11
Ohio,1986,75,2,79,156
Oklahoma,1986,4,0,14,18
Oregon,1986,1,0,9,10
Pennsylvania,1986,28,0,51,79
Rhode Island,1986,2,0,2,4
South Carolina,1986,3,0,14,17
South Dakota,1986,1,0,5,6
Tennessee,1986,22,1,27,50
Texas,1986,12,0,31,43
Utah,1986,1,0,5,6
Vermont,1986,2,0,6,8
Virginia,1986,16,0,42,58
Washington,1986,3,1,30,34
West Virginia,1986,3,0,5,8
Wisconsin,1986,47,0,47,94
Wyoming,1986,2,0,2,4
Alabama,1985,5,0,12,17
Alaska,1985,0,0,,0
Arizona,1985,4,0,11,15
Arkansas,1985,4,0,11,15
California,1985,62,0,115,177
Colorado,1985,11,1,18,30
Connecticut,1985,15,2,22,39
Delaware,1985,2,0,6,8
District of Columbia,1985,1,5,0,6
Florida,1985,17,2,27,46
Georgia,1985,16,1,15,32
Hawaii,1985,2,0,2,4
Idaho,1985,0,0,7,7
Illinois,1985,26126,895,4823,31844
Indiana,1985,64,2,69,135
Iowa,1985,24,2,42,68
Kansas,1985,13,0,27,40
Kentucky,1985,32,0,21,53
Louisiana,1985,6,0,17,23
Maine,1985,1,0,4,5
Maryland,1985,22,0,17,39
Massachusetts,1985,10,0,40,50
Michigan,1985,31,6,67,104
Minnesota,1985,14,0,53,67
Mississippi,1985,2,1,5,8
Missouri,1985,169,0,61,230
Montana,1985,3,0,9,12
Nebraska,1985,17,1,18,36
Nevada,1985,2,1,2,5
New Hampshire,1985,2,1,5,8
New Jersey,1985,64,0,39,103
New Mexico,1985,5,0,17,22
New York,1985,46,2,105,153
North Carolina,1985,3,1,23,27
North Dakota,1985,1,0,4,5
Ohio,1985,28,0,81,109
Oklahoma,1985,4,0,15,19
Oregon,1985,1,0,14,15
Pennsylvania,1985,20,0,60,80
Rhode Island,1985,3,0,5,8
South Carolina,1985,5,0,9,14
South Dakota,1985,1,0,7,8
Tennessee,1985,16,0,20,36
Texas,1985,12,0,31,43
Utah,1985,1,0,9,10
Vermont,1985,0,0,5,5
Virginia,1985,17,1,36,54
Washington,1985,1,0,21,22
West Virginia,1985,3,0,4,7
Wisconsin,1985,43,0,66,109
Wyoming,1985,1,0,5,6
Alabama,1984,8,0,11,19
Alaska,1984,0,0,0,0
Arizona,1984,4,0,11,15
Arkansas,1984,4,0,11,15
California,1984,64,0,107,171
Colorado,1984,10,0,31,41
Connecticut,1984,11,1,23,35
Delaware,1984,4,0,5,9
District of Columbia,1984,1,7,0,8
Florida,1984,25,0,30,55
Georgia,1984,15,0,8,23
Hawaii,1984,8,0,9,17
Idaho,1984,0,0,3,3
Illinois,1984,25124,904,4839,30867
Indiana,1984,67,3,74,144
Iowa,1984,23,1,37,61
Kansas,1984,10,1,18,29
Kentucky,1984,28,0,16,44
Louisiana,1984,4,0,12,16
Maine,1984,1,0,3,4
Maryland,1984,18,0,18,36
Massachusetts,1984,10,3,28,41
Michigan,1984,26,11,72,109
Minnesota,1984,11,0,58,69
Mississippi,1984,2,0,4,6
Missouri,1984,137,3,53,193
Montana,1984,1,0,8,9
Nebraska,1984,18,0,20,38
Nevada,1984,2,0,1,3
New Hampshire,1984,1,1,8,10
New Jersey,1984,49,3,43,95
New Mexico,1984,5,1,13,19
New York,1984,34,2,115,151
North Carolina,1984,6,0,22,28
North Dakota,1984,2,0,8,10
Ohio,1984,58,4,86,148
Oklahoma,1984,4,0,13,17
Oregon,1984,2,0,10,12
Pennsylvania,1984,25,0,64,89
Rhode Island,1984,3,0,4,7
South Carolina,1984,0,0,6,6
South Dakota,1984,1,0,10,11
Tennessee,1984,18,0,20,38
Texas,1984,10,0,33,43
Utah,1984,0,0,12,12
Vermont,1984,0,0,4,4
Virginia,1984,18,1,39,58
Washington,1984,3,0,22,25
West Virginia,1984,2,0,3,5
Wisconsin,1984,38,0,78,116
Wyoming,1984,1,0,2,3
Alabama,1983,7,0,10,17
Alaska,1983,0,0,3,3
Arizona,1983,3,0,8,11
Arkansas,1983,6,0,8,14
California,1983,41,1,113,155
Colorado,1983,10,1,21,32
Connecticut,1983,9,2,23,34
Delaware,1983,4,0,5,9
District of Columbia,1983,2,4,0,6
Florida,1983,27,0,28,55
Georgia,1983,11,0,13,24
Hawaii,1983,12,0,14,26
Idaho,1983,1,0,8,9
Illinois,1983,25083,938,4874,30895
Indiana,1983,49,2,69,120
Iowa,1983,21,1,30,52
Kansas,1983,7,2,27,36
Kentucky,1983,20,0,14,34
Louisiana,1983,2,0,11,13
Maine,1983,2,0,2,4
Maryland,1983,13,0,28,41
Massachusetts,1983,8,1,36,45
Michigan,1983,28,9,55,92
Minnesota,1983,11,0,59,70
Mississippi,1983,1,0,5,6
Missouri,1983,128,4,62,194
Montana,1983,2,0,7,9
Nebraska,1983,11,0,15,26
Nevada,1983,0,0,1,1
New Hampshire,1983,0,0,1,1
New Jersey,1983,43,2,39,84
New Mexico,1983,5,1,16,22
New York,1983,27,3,126,156
North Carolina,1983,5,0,27,32
North Dakota,1983,0,0,5,5
Ohio,1983,60,3,95,158
Oklahoma,1983,2,0,8,10
Oregon,1983,2,0,14,16
Pennsylvania,1983,31,0,66,97
Rhode Island,1983,1,0,,1
South Carolina,1983,1,0,5,6
South Dakota,1983,2,0,7,9
Tennessee,1983,13,0,18,31
Texas,1983,10,1,47,58
Utah,1983,0,0,9,9
Vermont,1983,0,0,8,8
Virginia,1983,13,2,27,42
Washington,1983,4,0,13,17
West Virginia,1983,0,0,7,7
Wisconsin,1983,33,2,73,108
Wyoming,1983,0,0,2,2
Alabama,1982,6,0,13,19
Alaska,1982,1,0,3,4
Arizona,1982,4,0,8,12
Arkansas,1982,7,0,5,12
California,1982,50,1,90,141
Colorado,1982,10,1,16,27
Connecticut,1982,10,0,31,41
Delaware,1982,2,0,8,10
District of Columbia,1982,3,7,0,10
Florida,1982,32,1,37,70
Georgia,1982,9,0,15,24
Hawaii,1982,10,0,9,19
Idaho,1982,0,0,7,7
Illinois,1982,25416,928,4971,31315
Indiana,1982,61,3,60,124
Iowa,1982,15,1,40,56
Kansas,1982,11,1,26,38
Kentucky,1982,20,0,16,36
Louisiana,1982,3,0,6,9
Maine,1982,1,0,3,4
Maryland,1982,7,0,32,39
Massachusetts,1982,12,0,39,51
Michigan,1982,24,7,60,91
Minnesota,1982,9,1,44,54
Mississippi,1982,1,0,3,4
Missouri,1982,112,5,9,126
Montana,1982,1,0,4,5
Nebraska,1982,11,0,10,21
Nevada,1982,1,0,2,3
New Hampshire,1982,1,0,1,2
New Jersey,1982,35,4,49,88
New Mexico,1982,4,0,13,17
New York,1982,29,5,119,153
North Carolina,1982,5,0,27,32
North Dakota,1982,0,0,4,4
Ohio,1982,54,6,87,147
Oklahoma,1982,6,0,9,15
Oregon,1982,1,1,8,10
Pennsylvania,1982,26,1,63,90
Rhode Island,1982,0,0,3,3
South Carolina,1982,1,0,8,9
South Dakota,1982,0,1,8,9
Tennessee,1982,13,0,17,30
Texas,1982,12,1,52,65
Utah,1982,0,1,7,8
Vermont,1982,0,0,3,3
Virginia,1982,14,1,33,48
Washington,1982,1,1,17,19
West Virginia,1982,2,0,7,9
Wisconsin,1982,36,3,76,115
Wyoming,1982,0,0,0,0
Alabama,1981,6,1,15,22
Alaska,1981,0,0,2,2
Arizona,1981,4,0,8,12
Arkansas,1981,3,0,4,7
California,1981,39,1,81,121
Colorado,1981,13,0,12,25
Connecticut,1981,15,1,28,44
Delaware,1981,2,0,7,9
District of Columbia,1981,2,7,0,9
Florida,1981,35,2,30,67
Georgia,1981,6,0,11,17
Hawaii,1981,7,0,5,12
Idaho,1981,1,0,5,6
Illinois,1981,25695,915,4908,31518
Indiana,1981,69,7,78,154
Iowa,1981,18,1,30,49
Kansas,1981,10,1,20,31
Kentucky,1981,11,0,24,35
Louisiana,1981,5,0,9,14
Maine,1981,2,0,5,7
Maryland,1981,8,2,38,48
Massachusetts,1981,16,0,41,57
Michigan,1981,25,6,75,106
Minnesota,1981,13,1,45,59
Mississippi,1981,5,0,6,11
Missouri,1981,96,7,61,164
Montana,1981,3,0,4,7
Nebraska,1981,7,0,10,17
Nevada,1981,0,0,2,2
New Hampshire,1981,1,0,7,8
New Jersey,1981,34,3,51,88
New Mexico,1981,2,0,11,13
New York,1981,3,5,128,136
North Carolina,1981,6,0,33,39
North Dakota,1981,1,1,3,5
Ohio,1981,43,2,98,143
Oklahoma,1981,3,0,12,15
Oregon,1981,2,2,8,12
Pennsylvania,1981,19,5,68,92
Rhode Island,1981,2,0,4,6
South Carolina,1981,0,0,13,13
South Dakota,1981,0,1,5,6
Tennessee,1981,17,1,23,41
Texas,1981,13,1,47,61
Utah,1981,0,0,13,13
Vermont,1981,0,0,3,3
Virginia,1981,12,0,34,46
Washington,1981,0,1,19,20
West Virginia,1981,1,0,8,9
Wisconsin,1981,43,3,52,98
Wyoming,1981,0,0,1,1
Alabama,1980,3,0,13,16
Alaska,1980,0,0,2,2
Arizona,1980,4,0,7,11
Arkansas,1980,5,0,4,9
California,1980,2,0,101,103
Colorado,1980,7,1,1,9
Connecticut,1980,18,2,29,49
Delaware,1980,3,0,7,10
District of Columbia,1980,3,8,0,11
Florida,1980,30,2,30,62
Georgia,1980,7,0,6,13
Hawaii,1980,3,0,2,5
Idaho,1980,1,0,7,8
Illinois,1980,25615,913,4686,31214
Indiana,1980,68,2,92,162
Iowa,1980,20,1,38,59
Kansas,1980,14,2,22,38
Kentucky,1980,7,0,21,28
Louisiana,1980,2,0,8,10
Maine,1980,1,0,3,4
Maryland,1980,10,1,32,43
Massachusetts,1980,10,1,46,57
Michigan,1980,30,11,69,110
Minnesota,1980,9,1,45,55
Mississippi,1980,4,0,7,11
Missouri,1980,86,4,76,166
Montana,1980,0,0,4,4
Nebraska,1980,8,1,15,24
Nevada,1980,0,0,2,2
New Hampshire,1980,0,0,8,8
New Jersey,1980,32,4,46,82
New Mexico,1980,1,0,11,12
New York,1980,28,9,124,161
North Carolina,1980,3,0,30,33
North Dakota,1980,0,1,3,4
Ohio,1980,41,5,92,138
Oklahoma,1980,3,0,9,12
Oregon,1980,4,0,8,12
Pennsylvania,1980,23,3,86,112
Rhode Island,1980,6,0,8,14
South Carolina,1980,1,0,11,12
South Dakota,1980,1,1,11,13
Tennessee,1980,21,0,23,44
Texas,1980,16,1,40,57
Utah,1980,0,0,11,11
Vermont,1980,0,0,4,4
Virginia,1980,16,0,36,52
Washington,1980,3,1,20,24
West Virginia,1980,2,0,6,8
Wisconsin,1980,39,4,63,106
Wyoming,1980,1,0,2,3
Alabama,1979,1,0,12,13
Alaska,1979,0,0,1,1
Arizona,1979,3,0,10,13
Arkansas,1979,8,0,5,13
California,1979,12,1,79,92
Colorado,1979,8,0,16,24
Connecticut,1979,19,1,23,43
Delaware,1979,3,0,6,9
District of Columbia,1979,2,3,0,5
Florida,1979,27,3,41,71
Georgia,1979,8,1,8,17
Hawaii,1979,2,0,6,8
Idaho,1979,2,0,7,9
Illinois,1979,25269,903,4775,30947
Indiana,1979,60,2,88,150
Iowa,1979,29,1,44,74
Kansas,1979,8,1,23,32
Kentucky,1979,11,1,16,28
Louisiana,1979,2,0,12,14
Maine,1979,1,0,4,5
Maryland,1979,6,2,18,26
Massachusetts,1979,12,2,44,58
Michigan,1979,27,9,63,99
Minnesota,1979,8,0,33,41
Mississippi,1979,3,0,2,5
Missouri,1979,78,0,63,141
Montana,1979,0,0,4,4
Nebraska,1979,6,1,14,21
Nevada,1979,0,0,1,1
New Hampshire,1979,3,0,13,16
New Jersey,1979,29,1,57,87
New Mexico,1979,3,0,10,13
New York,1979,39,8,137,184
North Carolina,1979,4,0,29,33
North Dakota,1979,1,1,7,9
Ohio,1979,36,4,103,143
Oklahoma,1979,3,0,15,18
Oregon,1979,2,0,7,9
Pennsylvania,1979,20,4,86,110
Rhode Island,1979,5,0,6,11
South Carolina,1979,1,0,12,13
South Dakota,1979,2,1,4,7
Tennessee,1979,16,0,21,37
Texas,1979,15,0,36,51
Utah,1979,2,0,11,13
Vermont,1979,4,0,4,8
Virginia,1979,28,0,28,56
Washington,1979,18,0,18,36
West Virginia,1979,5,0,5,10
Wisconsin,1979,51,6,51,108
Wyoming,1979,4,0,4,8
Alabama,1978,2,0,10,12
Alaska,1978,0,0,2,2
Arizona,1978,4,0,13,17
Arkansas,1978,6,0,5,11
California,1978,16,2,87,105
Colorado,1978,2,0,10,12
Connecticut,1978,20,1,20,41
Delaware,1978,1,1,9,11
District of Columbia,1978,5,4,0,9
Florida,1978,17,1,34,52
Georgia,1978,3,1,13,17
Hawaii,1978,5,0,12,17
Idaho,1978,0,0,2,2
Illinois,1978,24593,920,4738,30251
Indiana,1978,54,4,93,151
Iowa,1978,29,1,38,68
Kansas,1978,6,0,25,31
Kentucky,1978,12,0,18,30
Louisiana,1978,2,0,10,12
Maine,1978,0,0,7,7
Maryland,1978,5,1,29,35
Massachusetts,1978,16,2,47,65
Michigan,1978,20,5,55,80
Minnesota,1978,9,0,36,45
Mississippi,1978,6,0,6,12
Missouri,1978,66,4,67,137
Montana,1978,0,0,4,4
Nebraska,1978,12,1,13,26
Nevada,1978,0,0,2,2
New Hampshire,1978,1,0,12,13
New Jersey,1978,36,3,43,82
New Mexico,1978,5,0,14,19
New York,1978,41,6,164,211
North Carolina,1978,3,0,29,32
North Dakota,1978,1,1,8,10
Ohio,1978,41,2,107,150
Oklahoma,1978,2,1,11,14
Oregon,1978,2,1,8,11
Pennsylvania,1978,29,2,92,123
Rhode Island,1978,3,0,5,8
South Carolina,1978,4,0,6,10
South Dakota,1978,0,0,3,3
Tennessee,1978,10,0,21,31
Texas,1978,11,1,46,58
Utah,1978,0,0,10,10
Vermont,1978,8,0,8,16
Virginia,1978,33,0,33,66
Washington,1978,28,0,28,56
West Virginia,1978,1,0,1,2
Wisconsin,1978,56,5,56,117
Wyoming,1978,5,0,5,10
Alabama,1977,3,0,20,23
Alaska,1977,1,0,1,2
Arizona,1977,3,1,18,22
Arkansas,1977,6,0,11,17
California,1977,14,0,104,118
Colorado,1977,5,0,12,17
Connecticut,1977,21,3,31,55
Delaware,1977,3,2,8,13
District of Columbia,1977,3,7,0,10
Florida,1977,17,3,37,57
Georgia,1977,1,1,19,21
Hawaii,1977,7,0,7,14
Idaho,1977,3,0,3,6
Illinois,1977,24557,1036,4938,30531
Indiana,1977,57,4,91,152
Iowa,1977,21,1,32,54
Kansas,1977,3,1,34,38
Kentucky,1977,12,0,21,33
Louisiana,1977,4,1,18,23
Maine,1977,1,0,8,9
Maryland,1977,6,0,28,34
Massachusetts,1977,13,0,30,43
Michigan,1977,28,2,64,94
Minnesota,1977,7,2,48,57
Mississippi,1977,2,0,12,14
Missouri,1977,63,2,59,124
Montana,1977,1,1,5,7
Nebraska,1977,11,0,15,26
Nevada,1977,1,0,4,5
New Hampshire,1977,2,0,11,13
New Jersey,1977,39,5,51,95
New Mexico,1977,2,0,17,19
New York,1977,53,6,149,208
North Carolina,1977,6,1,39,46
North Dakota,1977,1,0,6,7
Ohio,1977,50,1,111,162
Oklahoma,1977,4,0,13,17
Oregon,1977,0,1,17,18
Pennsylvania,1977,29,4,81,114
Rhode Island,1977,2,0,5,7
South Carolina,1977,2,1,8,11
South Dakota,1977,0,0,5,5
Tennessee,1977,9,0,22,31
Texas,1977,9,1,45,55
Utah,1977,0,0,8,8
Vermont,1977,1,0,8,9
Virginia,1977,20,0,32,52
Washington,1977,3,0,24,27
West Virginia,1977,3,0,4,7
Wisconsin,1977,29,1,64,94
Wyoming,1977,1,0,4,5
Alabama,1976,4,0,16,20
Alaska,1976,1,0,2,3
Arizona,1976,1,1,16,18
Arkansas,1976,4,0,9,13
California,1976,18,2,89,109
Colorado,1976,4,0,14,18
Connecticut,1976,12,1,34,47
Delaware,1976,1,1,6,8
District of Columbia,1976,3,5,0,8
Florida,1976,16,4,31,51
Georgia,1976,3,0,24,27
Hawaii,1976,7,1,7,15
Idaho,1976,1,0,5,6
Illinois,1976,24052,1032,5178,30262
Indiana,1976,70,2,90,162
Iowa,1976,14,1,34,49
Kansas,1976,3,0,20,23
Kentucky,1976,7,0,15,22
Louisiana,1976,2,1,24,27
Maine,1976,1,0,9,10
Maryland,1976,13,0,34,47
Massachusetts,1976,12,4,39,55
Michigan,1976,21,4,73,98
Minnesota,1976,6,2,38,46
Mississippi,1976,1,0,12,13
Missouri,1976,54,3,61,118
Montana,1976,0,0,2,2
Nebraska,1976,10,0,16,26
Nevada,1976,1,0,2,3
New Hampshire,1976,2,0,11,13
New Jersey,1976,36,5,47,88
New Mexico,1976,1,0,15,16
New York,1976,52,6,187,245
North Carolina,1976,4,0,33,37
North Dakota,1976,1,0,6,7
Ohio,1976,45,3,118,166
Oklahoma,1976,2,0,15,17
Oregon,1976,1,0,17,18
Pennsylvania,1976,31,3,88,122
Rhode Island,1976,1,0,7,8
South Carolina,1976,2,0,13,15
South Dakota,1976,1,0,2,3
Tennessee,1976,4,1,23,28
Texas,1976,11,0,37,48
Utah,1976,0,0,9,9
Vermont,1976,0,0,4,4
Virginia,1976,15,0,39,54
Washington,1976,5,0,14,19
West Virginia,1976,3,0,5,8
Wisconsin,1976,30,2,64,96
Wyoming,1976,1,0,0,1
Alabama,1975,3,1,17,21
Alaska,1975,0,0,2,2
Arizona,1975,3,0,10,13
Arkansas,1975,5,1,5,11
California,1975,18,2,97,117
Colorado,1975,3,2,21,26
Connecticut,1975,8,1,38,47
Delaware,1975,1,2,7,10
District of Columbia,1975,3,4,0,7
Florida,1975,14,1,31,46
Georgia,1975,3,0,23,26
Hawaii,1975,7,0,9,16
Idaho,1975,1,0,6,7
Illinois,1975,25049,1017,5582,31648
Indiana,1975,70,0,83,153
Iowa,1975,14,2,38,54
Kansas,1975,4,0,26,30
Kentucky,1975,7,0,32,39
Louisiana,1975,2,0,17,19
Maine,1975,1,0,5,6
Maryland,1975,10,1,43,54
Massachusetts,1975,12,4,46,62
Michigan,1975,15,6,58,79
Minnesota,1975,12,3,33,48
Mississippi,1975,0,0,16,16
Missouri,1975,56,2,73,131
Montana,1975,0,0,4,4
Nebraska,1975,11,0,20,31
Nevada,1975,1,0,0,1
New Hampshire,1975,2,0,9,11
New Jersey,1975,46,2,58,106
New Mexico,1975,1,0,14,15
New York,1975,55,4,218,277
North Carolina,1975,9,0,30,39
North Dakota,1975,3,0,3,6
Ohio,1975,51,5,132,188
Oklahoma,1975,5,1,12,18
Oregon,1975,3,0,18,21
Pennsylvania,1975,36,2,107,145
Rhode Island,1975,1,0,7,8
South Carolina,1975,3,1,18,22
South Dakota,1975,1,0,3,4
Tennessee,1975,8,1,33,42
Texas,1975,11,1,42,54
Utah,1975,0,0,5,5
Vermont,1975,0,0,1,1
Virginia,1975,15,0,41,56
Washington,1975,3,0,24,27
West Virginia,1975,2,0,10,12
Wisconsin,1975,30,3,73,106
Wyoming,1975,0,0,1,1
